>0-Church
|0:0:10+0:1:0|0:0:10+0:2:0|0:0:10+0:3:0|0:0:10+0:2:0|0:3:10+0:3:0|0:4:10+0:2:0|0:0:10+0:3:0|0:0:10+0:2:0|0:0:10+0:3:0|0:0:10+0:2:0|0:3:10+0:3:0|0:4:10+0:2:0|0:0:10+0:3:0|0:0:10+0:2:0|0:0:10+0:3:0|0:0:10+0:2:0|0:3:10+0:3:0|0:4:10+0:2:0|0:3:0|0:2:0|0:3:10+0:3:0|0:4:10+0:2:0|0:3:0|0:2:0|0:3:10+0:3:0|0:4:10+0:2:0|0:3:0|0:2:0|0:3:0|0:4:0
|0:0:10+0:1:1|0:0:10+0:2:1|0:0:10+0:3:1|0:0:10+0:2:1|0:3:11+0:3:1|0:4:11+0:2:1|0:0:10+0:3:1|0:0:10+0:2:1|0:0:10+0:3:1|0:0:10+0:2:1|0:3:11+0:3:1|0:4:11+0:2:1|0:0:10+0:3:1|0:0:10+0:2:1|0:0:10+0:3:1|0:0:10+0:2:1|0:3:11+0:3:1|0:4:11+0:2:1|0:3:1|0:2:1|0:3:11+0:3:1|0:4:11+0:2:1|0:3:1|0:2:1|0:3:11+0:3:1|0:4:11+0:2:1|0:3:1|0:2:1|0:3:1|0:4:1
|0:0:10+0:7:2|0:0:10+0:8:2|0:0:10+0:0:0|0:0:10+0:0:0|0:3:10+0:0:0|0:4:10+0:0:0|0:0:10+0:0:0|0:0:10+0:0:0|0:0:10+0:0:0|0:0:10+0:0:0|0:3:10+0:0:0|0:4:10+0:0:0|0:0:10+0:0:0|0:0:10+0:0:0|0:0:10+0:0:0|0:0:10+0:0:0|0:3:10+0:0:0|0:4:10+0:0:0|0:0:10+0:0:0|0:0:10+0:0:0|0:3:10+0:0:0|0:4:10+0:0:0|0:0:10+0:0:0|0:0:10+0:0:0|0:3:10+0:0:0|0:4:10+0:0:0|0:0:10+0:0:0|0:0:10+0:0:0|0:0:10+0:7:2|0:0:10+0:8:2
|0:0:10+0:7:5|0:0:10+0:8:5|0:0:10+0:0:0|0:0:10+0:0:0|0:3:11+0:0:0|0:4:11+0:0:0|0:0:10+0:0:0|0:0:10+0:0:0|0:0:10+0:0:0|0:0:10+0:0:0|0:3:11+0:0:0|0:4:11+0:0:0|0:0:10+0:0:0|0:0:10+0:0:0|0:0:10+0:0:0|0:0:10+0:0:0|0:3:11+0:0:0|0:4:11+0:0:0|0:0:10+0:0:0|0:0:10+0:0:0|0:3:11+0:0:0|0:4:11+0:0:0|0:0:10+0:0:0|0:0:10+0:0:0|0:3:11+0:0:0|0:4:11+0:0:0|0:0:10+0:0:0|0:0:10+0:0:0|0:0:10+0:7:5|0:0:10+0:8:5
|0:0:10+0:7:0|0:0:10+0:8:0|0:0:10+0:0:0|0:0:10+0:0:0|0:3:10+0:0:0|0:4:10+0:0:0|0:0:10+0:0:0|0:1:10+0:0:0|0:2:10+0:0:0|0:0:10+0:0:0|0:3:10+0:0:0|0:4:10+0:0:0|0:0:10+0:0:0|0:1:10+0:0:0|0:2:10+0:0:0|0:0:10+0:0:0|0:3:10+0:0:0|0:4:10+0:0:0|0:0:10+0:0:0|0:0:10+0:0:0|0:3:10+0:0:0|0:4:10+0:0:0|0:0:10+0:0:0|0:0:10+0:0:0|0:3:10+0:0:0|0:4:10+0:0:0|0:0:10+0:0:0|0:0:10+0:0:0|0:0:10+0:7:0|0:0:10+0:8:0
|0:0:10+0:5:2|0:0:10+0:6:2|0:0:10+0:0:0|0:0:10+0:0:0|0:3:11+0:0:0|0:4:11+0:0:0|0:0:10+0:0:0|0:1:11+0:0:0|0:2:11+0:0:0|0:0:10+0:0:0|0:3:11+0:0:0|0:4:11+0:0:0|0:0:10+0:0:0|0:1:11+0:0:0|0:2:11+0:0:0|0:0:10+0:0:0|0:3:11+0:0:0|0:4:11+0:0:0|0:0:10+0:0:0|0:0:10+0:0:0|0:3:11+0:0:0|0:4:11+0:0:0|0:0:10+0:0:0|0:0:10+0:0:0|0:3:11+0:0:0|0:4:11+0:0:0|0:0:10+0:0:0|0:0:10+0:0:0|0:0:10+0:5:2|0:0:10+0:6:2
|0:0:10+0:7:5|0:0:10+0:8:5|0:0:10+0:0:0|0:0:10+0:0:0|0:5:11+0:0:0|0:6:11+0:0:0|0:0:10+0:0:0|0:1:12+0:0:0|0:2:12+0:0:0|0:0:10+0:0:0|0:3:10+0:0:0|0:4:10+0:0:0|0:0:10+0:0:0|0:1:12+0:0:0|0:2:12+0:0:0|0:0:10+0:0:0|0:5:11+0:0:0|0:6:11+0:0:0|0:0:10+0:0:0|0:0:10+0:0:0|0:3:10+0:0:0|0:4:10+0:0:0|0:0:10+0:0:0|0:0:10+0:0:0|0:5:11+0:0:0|0:6:11+0:0:0|0:0:10+0:0:0|0:0:10+0:0:0|0:0:10+0:7:5|0:0:10+0:8:5
|0:0:10+0:7:3|0:0:10+0:8:3|0:0:10+0:0:0|0:0:10+0:0:0|0:5:12+0:0:0|0:6:12+0:0:0|0:0:10+0:0:0|0:1:13+0:0:0|0:2:13+0:0:0|0:0:10+0:0:0|0:3:11+0:0:0|0:4:11+0:0:0|0:0:10+0:0:0|0:1:13+0:0:0|0:2:13+0:0:0|0:0:10+0:0:0|0:5:12+0:0:0|0:6:12+0:0:0|0:0:10+0:0:0|0:0:10+0:0:0|0:3:11+0:0:0|0:4:11+0:0:0|0:0:10+0:0:0|0:0:10+0:0:0|0:5:12+0:0:0|0:6:12+0:0:0|0:0:10+0:0:0|0:0:10+0:0:0|0:0:10+0:7:3|0:0:10+0:8:3
|0:0:10+0:0:0|0:0:10+0:0:0|0:0:10+0:0:0|0:0:10+0:0:0|0:3:10+0:0:0|0:4:10+0:0:0|0:0:10+0:0:0|0:0:10+0:0:0|0:0:10+0:0:0|0:0:10+0:0:0|0:3:10+0:0:0|0:4:10+0:0:0|0:0:10+0:0:0|0:0:10+0:0:0|0:0:10+0:0:0|0:0:10+0:0:0|0:3:10+0:0:0|0:4:10+0:0:0|0:0:10+0:0:0|0:0:10+0:0:0|0:3:10+0:0:0|0:4:10+0:0:0|0:0:10+0:0:0|0:0:10+0:0:0|0:3:10+0:0:0|0:4:10+0:0:0|0:0:10+0:0:0|0:0:10+0:0:0|0:0:10+0:0:0|0:0:10+0:0:0
|0:0:10+0:0:0|0:0:10+0:0:0|0:0:10+0:0:0|0:0:10+0:0:0|0:3:11+0:0:0|0:4:11+0:0:0|0:0:10+0:0:0|0:0:10+0:0:0|0:0:10+0:0:0|0:0:10+0:0:0|0:3:11+0:0:0|0:4:11+0:0:0|0:0:10+0:0:0|0:0:10+0:0:0|0:0:10+0:0:0|0:0:10+0:0:0|0:3:11+0:0:0|0:4:11+0:0:0|0:0:10+0:0:0|0:0:10+0:0:0|0:3:11+0:0:0|0:4:11+0:0:0|0:0:10+0:0:0|0:0:10+0:0:0|0:3:11+0:0:0|0:4:11+0:0:0|0:0:10+0:0:0|0:0:10+0:0:0|0:0:10+0:0:0|0:0:10+0:0:0
|0:0:10+0:0:0|0:0:10+0:0:0|0:0:10+0:0:0+0:5:6|0:0:10+0:0:0|0:3:10+0:0:0|0:4:10+0:0:0|0:0:10+0:0:0|0:0:10+0:0:0|0:0:10+0:0:0+0:5:6|0:0:10+0:0:0|0:3:10+0:0:0|0:4:10+0:0:0|0:0:10+0:0:0|0:0:10+0:0:0|0:0:10+0:0:0|0:0:10+0:3:7|0:3:10+0:4:7|0:4:10+0:5:7|0:0:10+0:0:0|0:0:10+0:0:0|0:3:10+0:0:0|0:4:10+0:0:0|0:0:10+0:0:0|0:0:10+0:0:0|0:3:10+0:6:7|0:4:10+0:1:7|0:0:10+0:2:7|0:0:10+0:6:7|0:0:10+0:7:7|0:0:10+0:8:7
|0:0:10+0:0:0|0:0:10+0:0:0|0:0:10+0:0:0+0:1:2|0:0:10+0:0:0|0:3:11+0:0:0|0:4:11+0:0:0|0:0:10+0:0:0|0:0:10+0:0:0|0:0:10+0:0:0+0:1:2|0:0:10+0:0:0|0:3:11+0:0:0|0:4:11+0:0:0|0:0:10+0:0:0|0:0:10+0:0:5|0:0:10+0:1:5|0:0:10+0:3:8|0:3:11+0:4:8|0:4:11+0:5:8|0:0:10+0:0:0|0:0:10+0:0:0|0:3:11+0:5:0|0:4:11+0:6:0|0:0:10+0:0:0|0:0:10+0:0:0|0:3:11+0:0:8|0:4:11+0:1:8|0:0:10+0:2:8|0:0:10+0:6:8|0:0:10+0:7:8|0:0:10+0:8:8
|0:0:10+0:0:0|0:0:10+0:0:0|0:0:10+0:0:0+0:0:3|0:0:10+0:0:0+0:1:3|0:3:10+0:0:0+0:2:3|0:4:10+0:0:0+0:1:3|0:0:10+0:0:0+0:2:3|0:0:10+0:0:0+0:3:3|0:0:10+0:0:0+0:4:3|0:0:10+0:0:0|0:3:10+0:0:0|0:4:10+0:0:5|0:0:10+0:1:5|0:0:10+0:0:6|0:0:10+0:1:6|0:0:10+0:3:9|0:3:10+0:4:9|0:4:10+0:5:9|0:0:10+0:0:0|0:0:10+0:0:0|0:3:10+0:5:1|0:4:10+0:6:1|0:0:10+0:0:0|0:0:10+0:0:0|0:3:10+0:0:9|0:4:10+0:1:9|0:0:10+0:2:9|0:0:10+0:6:9|0:0:10+0:7:9|0:0:10+0:8:9
|0:0:10+0:0:7|0:0:10+0:1:7|0:0:10+0:2:7+0:0:4|0:0:10+0:3:7+0:1:4|0:3:11+0:4:7+0:2:4|0:4:11+0:5:7+0:1:4|0:0:10+0:6:7+0:2:4|0:0:10+0:7:7+0:3:4|0:0:10+0:8:7+0:4:4|0:0:10+0:0:5|0:3:11+0:1:5|0:4:11+0:0:6|0:0:10+0:1:6|0:0:10+0:0:1|0:0:10+0:0:1|0:0:10+0:0:1|0:3:11+0:0:1|0:4:11+0:0:1|0:0:10+0:0:0|0:0:10+0:0:0|0:3:11+0:5:2|0:4:11+0:6:2|0:0:10+0:0:0|0:0:10+0:0:0|0:3:11+0:0:1|0:4:11+0:0:1|0:0:10+0:0:1|0:0:10+0:0:1|0:0:10+0:0:1|0:0:10+0:0:1
|0:0:10+0:0:8|0:0:10+0:1:8|0:0:10+0:2:8|0:0:10+0:3:8|0:3:10+0:4:8|0:4:10+0:5:8|0:0:10+0:6:8|0:0:10+0:7:8|0:0:10+0:8:8|0:0:10+0:0:6|0:3:10+0:1:6|0:4:10+0:0:1|0:0:10+0:0:1|0:0:10+0:0:1|0:0:10+0:0:1|0:0:10+0:0:1|0:3:10+0:0:1|0:4:10+0:0:1|0:0:10+0:0:0|0:0:10+0:0:0|0:3:10+0:5:3|0:4:10+0:6:3|0:0:10+0:0:0|0:0:10+0:0:0|0:3:10+0:0:1|0:4:10+0:0:1|0:0:10+0:0:1|0:0:10+0:0:1|0:0:10+0:0:1|0:0:10+0:0:1
|0:0:10+0:0:9|0:0:10+0:1:9|0:0:10+0:2:9|0:0:10+0:3:9|0:3:11+0:4:9|0:4:11+0:5:9|0:0:10+0:6:9|0:0:10+0:7:9|0:0:10+0:8:9|0:0:10+0:0:1|0:3:11+0:0:1|0:4:11+0:0:1|0:0:10+0:0:1|0:0:10+0:0:1|0:0:10+0:0:1|0:0:10+0:0:1|0:3:11+0:0:1|0:4:11+0:0:1|0:0:10+0:0:0|0:0:10+0:0:0|0:3:11+0:0:1|0:4:11+0:0:1|0:0:10+0:0:0|0:0:10+0:0:0|0:3:11+0:0:1|0:4:11+0:0:1|0:0:10+0:0:1|0:0:10+0:0:1|0:0:10+0:0:1|0:0:10+0:0:1
